██████████████
██          ██
██  ██████  ██
██  ██  ██████
    ██        
██      ██  ██
██████████████
