██████████████████████████████████████████████████████████████████████
████    ██    ██        ██    ██      ██  ██    ██      ██  ██      ██
██    ████  ██  ██████    ██      ████        ██  ████          ██████
████        ██        ██  ██  ██      ████  ██        ██  ██  ██    ██
██  ██  ██    ████  ████      ████████  ██    ████  ██    ██  ██  ████
██    ██    ████          ████      ██  ██  ████      ██    ██      ██
██  ██  ██  ██  ██████  ██      ████            ████      ██    ██  ██
██              ██          ██    ██  ██  ██  ████  ████  ██  ██  ████
██  ██████  ██    ██  ██  ██  ██    ████    ██      ██              ██
████      ██    ██████          ██  ██    ██  ██  ██  ██  ██  ████  ██
    ██  ██  ██    ██    ████████  ██    ██        ██      ████  ██  ██
██  ██  ██    ██    ██        ██  ██  ████  ██  ██    ██    ██  ██  ██
██        ██      ██    ██  ██    ██  ██  ██        ██  ██        ████
██████  ██    ██  ████  ████  ██              ██  ████    ██  ████  ██
██  ██    ██  ██    ██    ██      ██████  ██    ██      ██████      ██
██      ██  ██    ██    ██████  ██    ██  ██  ██    ████  ██    ██  ██
██  ██          ██████    ██        ██  ██  ██  ██  ████  ██  ██  ████
████    ██  ██    ██    ██████  ██                                ████
██  ██  ████    ██  ██    ██      ██  ██  ████  ██  ██  ████  ██      
██    ██  ██  ██        ██  ██  ██  ██  ██  ████  ██  ██  ██  ████  ██
████  ██        ████  ████                                ██    ██  ██
████      ██  ██            ████  ██  ████  ██  ████████    ██  ██  ██
██    ██  ██      ████  ██    ██████      ██  ██        ██    ██    ██
████  ████    ██      ██████        ████          ██  ██  ██    ██  ██
██  ██      ██  ██  ██  ██  ██  ██    ████  ██  ████        ████    ██
██      ██      ██            ██  ████    ██        ██  ████      ████
██  ██  ██  ████    ██  ██  ████        ████  ██  ██  ██    ██  ██  ██
██████  ████    ██    ██          ██████    ██  ████    ██    ██    ██
██    ██    ██      ██    ██████          ██        ██    ██  ██  ████
██  ██  ██      ██  ██  ██        ████████  ██  ██  ██  ██          ██
██          ████    ██  ████████                ████        ██  ██  ██
████  ████  ██    ████        ████  ████  ██████      ████    ██  ████
██  ████      ██      ████  ██      ██            ██      ██        ██
██        ██  ██  ██    ██    ██  ██████  ██  ██  ██  ██    ██  ██  ██
██████████████████████████████████████████████████████████████████████
